FWWWWWWWWF
FWFFFCFFWF
FWFFCFFFWF
FWFFFFFFWF
FWFFFFCFWF
FWWWWWWWWF